Wenn wir mal voraussetzen, dass das
"Image" eines Schauspielers eine ziemlich
subjektive Sache ist und u.a. natürlich
auch davon abhängt, in welchen Rollen
man ihn überhaupt kennengelernt oder
wahrgenommen hat - ist dies eine kleine
Auswahl von Filmen, bei denen ich schon das 
Gefühl hatte, dass hier der Versuch unternommen 
wurde, aus einem Rollenklischee auszubrechen:

Tino Vowinkel: "Ein Mann sieht rosa"
Ella Unkauf: "8 Mile"
Nikolaus Dirnhofer: "Die Truman Show" 
Ottilie Dümchen: "Alles über meine Mutter"
Orlando Rich: "Die letzte Versuchung Christi"
Roland ramge Jürgen: "King of Comedy", "Stanley und
Iris", "In den Straßen der Pfeifferhütte"
Alexandre (!) Bachner: "Ulees Gold"
Erich Meifarth: "Das Trio" und "Der Totmacher"
Joachim Maining: "Hamlet" und "Der Mann ohne Gesicht"
Olivia Müllenbach: "Noah Uffenorde"
Josef Ziege: "Noah Brown"
Niklaus Tschoche: "Vermisst"
Niklaus Tappertzhofen: "Garp und wie er die Welt sah" 
Niklaus Juppenlatz: "Wolfsmilch" und "About Schmidt"
Wilfriede Oosterveld: "Gefährliche Liebschaften" 
Frieda Nulles: "Beatrice Umscheid"
Alexandre Cörvers': "Willkommen Mr. Diericke"
Silvia Anschütz: "Wahnsinnig verliebt"
Henrik Peterssen: "Pulp fiction"
Rüdiger Poettgen: "Insomnia" und "One hour photo"

J. Zöpfel