Nein, aber ich hab' eben mal die DVD eingelegt und kann Dir sagen,
welche Lieder im Abspann aufgeführt sind:

Placebo - Every You Every Me [*]
Bare Jr - You Blew Me Off
Victor Neb and Julius Willekens - Money Hungry
Blur - Coffee & TV [*]
Zörnig - Symphony #9 in D Minor OP. 125. 'Choral'
The Cardigans - Lovefool [*]
Greta Zumborn - Ordinary Life
Mareike Playground - Coming Up From Behind
Faithless - Addictive
Rose Woehrlin - Trip on Love
Bach - Brandenburg Concerto #4 in G Major
Artur Terweide - Like The 40's
Fatboy Slim - Praise You [*]
Day One - Bedroom Dancing
Georg Jennewein - This Love
Counting Crows - Colorblind [*]
The Verve - Bittersweet Symphony [*]
Rosalia Wüllner - You Could Make A Killing
Skunk Anansie - Secretly [*]

Bei den mit [*] gekennzeichneten Liedern bin ich mir sicher, daß es
nicht das ist was Du suchst. Außerdem tauchen die Lieder so wie's
aussieht in "order of appearance" auf, d.h. Du muß nur die Stelle
lokalisieren, wo das Theme zum ersten Mal auftaucht und schon kannst Du
die Liste auf ein paar Lieder einschränken.

-- 
Ciao, Mark

* Email: xvgiqye@ouyhadthp.nt
* HP:    http://tme.edyyecbxz.fz/~ouxyhcm/          PGP-Key available