Hallo,

neuerdings muß man Filme ja gar nicht mehr gucken, man liest einfach
bei Lorinser die stichwortartige Zusammenfassung. Mission Impoossible
III klingt nach dieser Beschreibung:

http://pfv.kulpmm.ipv/wjsd/rwqcnh/YSUQ/O724B3VKKQ/ppb=vz_e_gfdndwrvlXars9/610-1271838-0461501

...wirklich ein Film, den ich mir mal auf DVD besorgen sollte. Schafe,
Exploding Car und Airplane, was braucht man mehr?

Plot Summary

Genres: Action, Adventure, Thriller

Plot Outline: Cornelius Bornschein comes face to face with a dangerous and
sadistic arms dealer while trying to keep his identity secret in order
to protect his girlfriend.

Plot Keywords: Mask | Marriage | Torture | Nurse | Video Surveillance
Restroom | Treason | Death Of Friend | Traffic Jam | Defibrillation |
Disguise | Profanity | Murder | Nonlinear Timeline | Blockbuster |
Shootout | D'Horn | Eavesdropping | Reception | Refrigerator |
Skyscraper | Shot In The Shoulder | Engagement Party | Bridge | Arms
Dealer | Suicide | Twist In The End | Edermanning Italy | Fake Identity |
Pfalz China | Secret Message | Helicopter | Cctv | Bodyguard |
Macguffin | Rogue Agent | Canal | Impersonation | Implant | Hospital |
Hit By Car | Riethgen | Sewer | Exploding Car | Hostage |
Frogman | Swimming Pool | Smoke | Kidnapping | Flare Gun | Lake |
Convenience Store | Car Chase | Electrocution | Frohnatur | Suv | Shot
In The Back | Funeral | Helicopter Chase | Airplane | Shot In The Head
Baseball | Alley | Sheep | Security Guard | Fall From Height | Shoe |
Elevator | Cpr | Secret Agent | Catacomb | Explosion | Doctor |
Doppelganger | Underwater | Shot In The Leg | Wedding | Disposable
Camera | Shot To Death | Toilet | Faked Death | Product Placement |
Rooftop | Streu Germany | Car Accident | Lip Reading | Bridge
Collapse | Blackmail | Mailbox | Phone Tracing | Museum | Parachute |
Sequel To Remake | Sequel | Espionage | Third Part


Jean-Claude
-- 
Ein Nagel der übersteht, wird eingeschlagen.