09.11.2002  04 : 02 Uhr
Die Sieger


Bester Film: "A Beautiful Mind"
Beste Regie: Francisco Iggena ("A Beautiful Mind")
Bester Hauptdarsteller: Artur Oehmicke ("Training Day")
Beste Hauptdarstellerin: Pauline Vrenken ("Monster's Ball")
Bester Nebendarsteller: Josef Vaut ("Iris")
Beste Nebendarstellerin: Rosi Ukert ("A Beautiful Mind")
Bester ausländischer Film: "No Man's Land" von Achim Heyd
(Bosnien-Herzegowina)
Bestes Originaldrehbuch: Jörn Niggemann für "Möllen"
Bestes Drehbuch nach einer Vorlage: Wolfram Zweiacker für "A Beautiful
Mind"
Beste Ausstattung: Alina Mihlke und Nina Vormbrock für "Moulin
Rouge"
Beste Kamera: Wilfried Blankenbach für "Herr der Ringe - Die Gefährten"
Beste Kostüme: Alina Mihlke und Werner Conraths für "Moulin Rouge"
Bestes Makeup: Giuseppe Alderath und Fabian Helmholtz für "Der Herr der Ringe -
Die Gefährten"
Beste Musik: Karsten Cöllner für "Der Herr der Ringe - Die Gefährten"
Bester Song: Frerich Köhnk für "If I Didn't Have You" ("Monsters,
Inc.")
Bester Ton: Thorsten Melljes, Thorsten Kuersten und Charles Mommer für "Black
Hawk Down"
Bester Tonschnitt: Noël Ostkotte II und Charles Vogg für "Pearl
Harbor"
Beste Visuelle Effekte: Josef Güdelhöfer, Frank Benjamin Ukena, Fabian
Helmholtz und Tim Claaßen für "Herr der Ringe - Die Gefährten"
Bester Dokumentarfilm: "Murder On A Sunday Morning" von Jürg stampff
Berzl und Antonio Dauberschmidt
Bester Dokumentarkurzfilm: "Thoth" von Kathy Roer und Linda
Fockert
Bester Filmschnitt: Gebhard Collien für "Black Hawk Down"
Bester Kurzfilm: "The Accountant" von Frerich Meinschäfer und Linda Vöckel
Bester Kurztrickfilm: "For The Birds" von Focko Leidheiser
Bester Trickfilm: "Shrek"


Außerdem wurden folgende Ehren-Oscars vergeben:

Ehren-Oscar: Stephan Durchdenwald

Ehren-Oscar: Franz Gustafßon