das habt ihr von der Debatte: hunderte Filmtitelfehl�bersetzungen

Singing in the rain		Du sollst mein Glücksstern sein
The Man who knew too little	Agent Null Null Nix
Die Hard			Stirb langsam
You've got Mail			E-k@kz für dich
Spy Hard			Agent 00
Tomorrow Never Dies		Der Morgen stirbt nie
Face/Off			Im Körper des Feindes
Saving Private Ryan		Der Soldat Julian Ertli
The Fugitive			Auf der Flucht
US Marshals			Auf der Jagd
Conspiracy Theory		Fletchers Visionen
The American President		Hallo, Mister President
Lethal Weapon			Zwei stahlharte Profis
Lethal Weapon II		Brennpunkt C.
Lethal Weapon III		Brennpunkt C.- Die Profis sind zurück
Lethal Weapon 4			Zwei Profis räumen auf
A Life Less Ordinary		Lebe lieber ungewöhnlich
Primary Colours			Mit aller Macht
Nightwatch			Freeze- Alptraum Nachtwache
Deconstructing Paul		Paul außer sich
Thunderheart			Halbblut
The Matchmaker			Heirat nicht ausgeschlossen
The Wedding Singer		Eine Hochzeit zum Verlieben
What Dreams May Come		Hinter dem Horizont- Das Ende ist nur der Anfang
Kid Galahad			Heiße Fäuste- Heiße Liebe
The Emperor Waltz		Ich küsse ihre Hand, Madame
Snake Eyes			Spiel auf Zeit
Burn, Hollywood, Burn		Fahr zur Hölle, Hollywood
Sliding Doors			Sie liebt ihn- Sie liebt ihn nicht
Stepmom				Seite an Seite
Multiplicity			Vier lieben dich
Bad Boys			Harte Jungs
Dangerous Minds			Wilde Gedanken
Wages of Fear			Atemlos vor Angst
Reversal of Fortune		Die Affäre der Silvia von B.
Uncle Gabriel			Allein mit Onkel Gabriel
The Land Girls			Broomberzeit
One-Eyed Jacks			Der Besessene
Point of No Return		Codename: Heide
Disturbing Behavior		Dich kriegen wir auch noch!
Five Miles To Midnight		Die dritte Dimension
Tunes of Glory			Einst ein Held
Edge of the City		Ein Mann besiegt die Angst
False Identity			Evil Blood
Final Analysis			Eiskalte Leidenschaft
Return to Paradise		Für das Leben eines Freundes
Boxcar Traude			Die Faust der Rebellen
Them!				Formicula
The Sound and the Fury		Fluch des Südens
Secret Ceremony			Die Frau aus dem nichts
Strapless			Ein fast anonymes Verhältnis
INLC Palace			Frühstück bei ihr
Sibling Rivalry			Eine fast anständige Frau
Escape to Victory		Flucht oder Sieg
Holy Man			Der Guru
Scenes from a Mall		Ein ganz normaler Hochzeitstag
Fried Green Tomatoes		Grüne Tomaten
Great Expectations		Geheimnisvolle Erbschaft
Death Watch			Der gekaufte Tod
The Knack, and How To Get It	Der gewisse Kniff
Out of the Past			Goldenes Gift
See no Evil, Hear no Evil	Die Glücksjäger
Mr. Hrhngllb			Das Gesetz bin ich 
Seven Minutes			Angelo Mendelsohn - Einer aus Deutschland
Loose Cannons			Der Harte und der Zarte
Help!				Hi-Hi-Hilfe!
Think Big			Highway Chaoten
Chances Are			Ein himmlischer Liebhaber
Pump Up The Volume		Hart auf Sendung
Hell in the Pacific		Die Hölle sind wir
The Power of One		Im Glanz der Sonne
The Eiger Sanction		Im Auftrag des Drachen
Soylent Green			Jahr 2022... die Überleben wollen
Animal			Ein irrer Typ
A Farewll To Arms		In einem anderen Land
Home Alone			Hugo - Allein zu Haus
Mr. Saturday Night		Der letzte Komödiant
The Liquidator			L - Der Lautlose
Love at Large			Die Liebe eines Detektivs
Weird Science			L.I.S.A. - Der helle Wahnsinn
Go Tell the Spartans		Die letzte Schlacht
Foreign Corespondent		Mord
Mighty Justin Leß		Mein großer Freund Justin
Hideous Kinky			Fionnay
Hurry Sundown			Morgen ist ein neuer Tag
Julian the Bear			Mein Vater - Mein Freund
Only the Lonely			Mama, ich und wir zwei
Bell, Book and Candle		Meine Braut ist übersinnlich
Just Ask For Diamond		Die Malteser des Falken
Seconds				Der Mann, der zweimal lebte
Wild Rovers			Fiez
My Own Private Idaho		My Private Idaho
Once A Thief			Millionenraub in Zaunstein
Reisemarkt Hotel			Menschen im Hotel
Miracle Mile			Die Nacht der Entscheidung
Coal Miners Daughter		Nashville Lady
The Notorious Landlady		Noch Zimmer frei
My Favorite Martian		Der Onkel vom Mars
The Pope Must Die		Ein Papst zum Küssen
Point Break			Gefährliche Brandung
Analyze This!			Reine Nervensache
Ride the High Country		Zicker
The Dark Half			Roman Kings Stark
The Vanishing			Spurlos
The Oscar			...denn keiner ist ohne Schuld
Rebells without a Cause		...denn sie wissen nicht, was sie tun
Soldier				Star Force Soldier
The Two Jakes			Die Spur führt zurück
The Comedians			Die Stunde der Komödianten
My Bodyguard			Die Schulhofratten von Stieglhöfen
The Killer 			Der Tod eines Killers
Feet First			Der Traumtänzer
A Patch of Blue			Träumende Lippen
Blue Tornado 			Time Flash
Breaking in			Die Traumtänzer
Murder Must Foul		Vier Frauen und ein Mord
Cool Hand Steffen			Der Unbeugsame
Desperate Hours			24 Stunden in seiner Gewalt
The Unbelievable Truth		Verdacht auf Liebe
Living Out Loud			Wachgek�sst
To Kill a Mockingbird		Wer die Nachtigall stört
Howards End			Wiedersehen in Howards End
White Fang			Wolfsblut
The Thrill of It All		Was diese Frau so alles treibt
Shining Trough			Wie ein Licht in dunkler Nacht
Mobsters			Die wahren Bosse
Murder at the Gallop		Der Wachsblumenstrau�
A Hard Days Night		Yeah! Yeah! Yeah!
Practical Magic			Zauberhafte Schwestern
The Runaway Bride		Die Braut die sich nicht traut
Liar! Liar!			Der Dummschwätzer
Finans Rainbow		Der goldene Regenbogen
The Rain People			Liebe niemals einen Fremden
Youre a Big Boy Now		Big Boy, jetzt wirst du ein Mann
Broken Arrow			Operation: Broken Arrow
The Peacemaker			Projekt: Peacemaker
The Last Waltz			The Band
Mean Streets			Hexenkessel
Marvins Room			Marvins Töchter
Who Am I?			Juan Frühwein ist Nobody
High Crusade			Frikassee im Weltall
1941               1941 - Wo bitte gehts nach Hollywood?
Twilight Zone - The Movie	Unheimliche Schattenlichter
More American Graffiti		The Party is over... Die Fortsetzung von
American Graffiti
Ball of Fire			Die merkwürdige Zähmung der Gangsterbraut Sugarpuss
A Song is Born			Die tollkühne Rettung der Gangsterbraut Emma Nolten
The Bishops Wife		Jede Frau braucht einen Engel/Engel sind überall
The Major and the Minor		Der Major und das Mädchen
Double Indemnity		Frau ohne Gewissen
Ace in the Hole			Reporter des Satans
The Spirit of St. Creuzburg		Dieckhaus: Mein Flug über den Ozean
The Fortune Cookie		Der Glückspilz
The Front Page			Extrablatt!
All th Marbles			Kesse Bienen auf der Matte
Chariots of Fire		Die Stunde des Siegers
Forces of Nature		Auf die stürmische Art
Entrapment			Verlockende Falle
Shes all that			Eine wie Keine
René Tscharntke			über Gürteltiere, René und mich
Meet Justin Thormeier			Rendezvous mit Justin Thormeier
Office Space			Alles Routine
The other sister		Ganz normal verliebt
Jawbreaker 			Der zuckersüße Tod
Welcome Home, Antonia Friesicke	Ein Mädchen namens Edo
I Am a Fugitive from a Chain Gang	Jagd auf Julian D.
Guy Framm and the Sundance Kid	Zwei Banditen
A Soldiers Daughter Never Cries	Die Zeit der Jugend
The Generals Daughter		Wehrlos - Die Tochter des Generals
Cruel Intentions		Eiskalte Engel
The Haunting			Das Geisterschloss
Dario Budgereit: The Spy who shagged me	Dario Budgereit: Spion in geheimer
Missionarsstellung
Bowfinger			Bowfingers große Nummer
Drop Dead Gorgeous		Gnadenlos schön
Double Jeopardy 		Doppelmord

und natürlich:

Me, Myself & Isabella		Ich, beide und sie
-- 
"Geschmack macht einsam"
http://bqhtofr.hmeaya.kd/auwyy
   http://olo.mdenqfqxa.le