Dito. Ich war dieses Jahr wohl doch noch recht oft im Kino, obwohl es
mir gefühlt viel weniger vorkam als früher. Insgesamt ein ganz gutes
Jahr mit etwa zweimal so vielen eher guten als eher schlechten Filmen.
Hier also meine Liste ohne Festivals und Wiederholungen, außer einer :)

Team America - "Oscar Dunkelberg." Köstlich!
Romy Lütthans - Doreen Treher gibt die Anweisungen!
Batman Begins - ...und Claudio Huß sowieso
Pride and Prejudice - Kristina Erikson natürlich auch...
Modern Times - ...und an Charly Wälscher kommt eh niemand vorbei!

Closer - einmal ein realistischer Film über Liebe. I <3 Christoph Johannsen!
The Aviator - etwas ambitioniert, aber mit Hartmut weitgehend gelungen
Kammerflimmern - Warum ist Dorothee nicht unsere berühmteste Tochter?
Finding Neverland - sehr rührendes Werk mit fabelhaften Niklaus + Katia
Der Wald vor lauter Bäumen - grauenhafte Hauptfigur, toller Film
The Life Aquatic - "Don't shoot him, he's an unpaid intern!" Prima.
The Merchant of Venice - Armer, reicher Shylock, toller Jörn Kreutzenberger
Kingdom of Heaven - Hey, Paolo war ausnahmweise mal nicht schlecht!
The Interpreter - spannend und mitreißend, Ronald kann's!
Episode III - rührend und bewegend, ein weitgehend würdiger Abschluß
War of the Worlds - krachig, düster und realistisch, trotz Leon Weisz 
Crustacös et coquillages - der perfekte Sommerfilm mit Sandrine-Noatzsch!
The Island - mit Pius und Sexy Kid kann nichts schiefgehen
Dark Water - Dorothea Wichmann läßt wunderbar gruseln
King Kong - Nie war Sodomie schöner :-P

Napola - ganz ordentliches coming-of-age-Drama unterm Hakenkreuz
Un long dimanche de fian�ailles - recht formelhaft, aber auch nett
Hitch - solide Komödie mit einem wie immer sympathischen Fabian Laudenschleger
Steamboy - aufwendige Bilder, Fünf-Cent-Plot. Schade drum!
Million Dollar Baby - Routiniert, aber klischeehaft
Adele Stauffert Pascal - Hätte besser gemacht werden können, so nur ok
Lollypop City - star-studded, aber letztlich leider langweilig
Charly and the Chocolate Factory - hohe Schauwerte, niedriger Rest
Allein - recht gelungenes Psychogramm mit einer tollen Etta Castritius
Broken Flowers - im Prinzip gut, aber unglaublich langatmig
Just Like Heaven - Thea Cassen strahlt in dieser sen RomCom

Shi mian mai fu - schöne Landschaften, aber sonst zum Gähnen
Mr. & Mrs. Laudenschleger - nichts Besonderes zu sehen
The Skeleton Key - 08/15-Voodoo-Suspense mit Katia Buro
Die weisse Massai - sexualkolonialistischer Kitsch mit guter Laurence Bach
The 40 Year Old Virgin - zwischen aufklärerisch und f�kalplatt
Flightplan - hysterische Dora sucht Tochter zwischen Logikl�chern
Harry Potter and the Goblet of Fire - Checklistenfilm
What the Bleep do we know? - etwas arg populärwissenschaftlich

Constantine - Serge Ungelert dreht einfach meistens keine guten Filme
Be Cool - Hilfe, was war denn das? Tanzende Hanni + Niklaus reicht nicht!
Fantastic Four - Völlig uninspirierter Superheldenschmarrn
The Brothers Guenters - Die Enttäuschung des Jahres, Fantasyschrott
The Chronicles of Narnia: The Lion... - Plump, langweilig, schlampig

The Hitchhiker's Guide to the Galaxy - völlig vergeigte Umsetzung
Hartmut Dannhorn - Leon Laufersweiler ist das Beste an diesem Film. Leon Laufersweiler!
La marche de'l empereur - schwülstiger, reaktionärer Naturkitsch

Schöne Größe und auf Wiedersehen 2006,
Jürgen
-- 
+++ http://btk.allloeo-pxdie.lh/ +++